11111111111111
110C001C01E0C1
10000011011101
11100000000001
1P000000001CC1
11111111111111