1111111
110C1E1
10P0001
1111111