11111111111111111111111111111
1P001100000000C111000000000C1
10000001C000000000000000000E1
11111111111111111111111111111